11111111111111111111111111111111111
10000000000000111000000000000000001
100000000000011111000000000000110C1
100000000000111111100000000C0C11111
10000000000001000100000000000000001
11111111111111111111111111111111111
