111111111111111111111111111111111111111111
1000000000000000C0001000100000001000000001
100011111111100010001000C00001000011111001
100010000000100010001000111001111110C01001
100010000000100010001000001000000010001001
10001P00000010001000C000001000010000001C01
10000000000010001000C000001000010000001C01
10000000000010001000C000001000010000001C01
10000000000010001000C000001000010000001C01
10000000E00000000000C000000000000000000C01
111111111111111111111111111111111111111111