111111111111111111111111111111111111111111111
1C00000000000000C00010001000000000100000000P1
100011111111100010001000C00000010000011111001
100010000000100010001000111110011111110C01001
10001000E000100010001000000010000000010001001
10000000000010001000C000000010000010000001C01
111111111111111111111111111111111111111111111