111111111111111
10C1000001C00E1
101111010110111
1000C1010000001
101111000110001
100000010010P01
11C01111C010001
111111111111111