111111111111111
1PCE00000000001
100000000P00001
111111111111111