111111111111111
1PCE00000000001
1000000000X0001
111111111111111