111111111111111
1PC000000100001
100000000100E01
111111111111111