111111111111111
10CE00000100001
100000000100P01
111111111111111