111111111111111
1PCE00000100001
100000000100C01
111111111111111