111111111111111
1P0E00000000001
100000000000001
111111111111111