111111111111111
1PC000000000001
100000000000001
111111111111111