111111111111111
10CE00000000001
100000000000001
111111111111111