111111111111111
1PCE00000000001
100000000000001
111111011111111